>H210428-048_M09_1FDFZAF442_premix.ab1	1605
GGGGGAGTACGACACACAGATAAACGAAAGGCCCAGTCTTTCGACTGAGC
CTTTCGTTTTATTTGATGCCTTTAATTAAGAAGCGGAAGAGCGCCCAATA
CGCAAACCGCCTCTCCCCGCGCGTTGGCCGATTCATTAATGCAGCTGGCA
CGACAGGTTTCCCGACTGGAAAGCGGGCAGTGAGCGCAACGCAATTAATG
TGAGTTAGCTCACTCATTAGGCACCCCAGGCTTTACACTTTATGCTTCCG
GCTCGTATGTTGTGTGGAATTGTGAGCGGATAACAATTTCACACAGGAAA
CAGCTATGACCATGATTACGCCAAGCTTGCATGCCTGCAGGTCGACTCTA
GAGGATCCCCGGTCTCTAGCGAACACAACGAGCGATATTTTTGTATACAA
TATTTTGAAACGATCGTATCTCCTGAGACCGGGTACCGAGCTCGAATTCA
CTGGCCGTCGTTTTACAACGTCGTGACTGGGAAAACCCTGGCGTTACCCA
ACTTAATCGCCTTGCAGCACATCCCCCTTTCGCCAGCTGGCGTAATAGCG
AAGAGGCCCGCACCGATCGCCCTTCCCAACAGTTGCGCAGCCTGAATGGC
GAATGGCGCCTGATGCGGTATTTTCTCCTTACGCATCTGTGCGGTATTTC
ACACCGCATATGGTGCACTCTCAGTACAATCTGCTCTGATGCCGCATAGT
TAAGCCAGCCCCGACACCCGCCAACACCCGCTGAACTAGTCTTGGACTCC
TGTTGATAGATCCAGTAATGACCTCAGAACTCCATCTGGATTTGTTCAGA
ACGCTCGGTTGCCGCCGGGCGTTTTTTATTGGTGAGAATCCAGGGGTCCC
CAATAATTACGATTTAAATTAGTAGCCCGCCTAATGAGCGGGCTTTTTTT
TAATTCCCCTATTTGTTTATTTTTCTAAATACATTCAAATATGTATCCGC
TCATGAGACAATAACCCTGATAAATGCTTCAATAATATTGAAAAAGGAAG
AGTATGAGCATTCAGCATTTTCGTGTGGCGCTGATTCCGTTTTTTGCGGC
GTTTGGCCTGCCGGTGTTTGCGCATCCGGAAACCCTGGTGAAAGTGAAAG
ATGCGGAAGATCACTGGGTGCGCGCGTGGGCTATATTGACTGGATCTGAC
AGCGGCAAATCTGGAATCTTTCGTCGGAAGACGTTTTCGATGATAGACCC
TTTAAGGCTGCTGGGCGGGCGGTCTGAACCGGGGGATCGGGCCAGAACAA
TGGGGCCTCGATTCTTAAACCAAAGAATTGGTGAAAAACCGGGACCAAAA
ATTGACCGAAGTGACGGGTGAAGTGGAGGGGGGAAACAAAGAAAACCCGC
AACCCTGGGAAATGGGGCAAAAAAACGTTTTAAAAGGAAATGCCCCGCGG
TGGCAAAAAAAAAAAAAAAAAAAACCCCCGGCGCCCCCCCGGGGGGGGGG
CCCCCCCCTTGAAAGAAAAGAGGAGCCTCCCCTGGTGTGTTGAGTCGGCC
GCGCTGCCGACTCACCCCAGAACACATCAACCTTGTATTTCTCGTCATCC
TCCCCCGCCACCCCTACGCGCGCCGCAAACCCTCAGAAAAAAGTACGGAC
GAGCG