>H210428-048_K09_1FDFZAF440_premix.ab1	1585
GGGCGGCTTCGACAACACAGATAAACGAAAGGCCCAGTCTTTCGACTGAG
CCTTTCGTTTTATTTGATGCCTTTAATTAAGAAGCGGAAGAGCGCCCAAT
ACGCAAACCGCCTCTCCCCGCGCGTTGGCCGATTCATTAATGCAGCTGGC
ACGACAGGTTTCCCGACTGGAAAGCGGGCAGTGAGCGCAACGCAATTAAT
GTGAGTTAGCTCACTCATTAGGCACCCCAGGCTTTACACTTTATGCTTCC
GGCTCGTATGTTGTGTGGAATTGTGAGCGGATAACAATTTCACACAGGAA
ACAGCTATGACCATGATTACGCCAAGCTTGCATGCCTGCAGGTCGACTCT
AGAGGATCCCCGGTCTCTAGCGAACACAACGAGCGATATTTTTGTATACA
ATATTTTGAAACGATCGTATCTCCTGAGACCGGGTACCGAGCTCGAATTC
ACTGGCCGTCGTTTTACAACGTCGTGACTGGGAAAACCCTGGCGTTACCC
AACTTAATCGCCTTGCAGCACATCCCCCTTTCGCCAGCTGGCGTAATAGC
GAAGAGGCCCGCACCGATCGCCCTTCCCAACAGTTGCGCAGCCTGAATGG
CGAATGGCGCCTGATGCGGTATTTTCTCCTTACGCATCTGTGCGGTATTT
CACACCGCATATGGTGCACTCTCAGTACAATCTGCTCTGATGCCGCATAG
TTAAGCCAGCCCCGACACCCGCCAACACCCGCTGAACTAGTCTTGGACTC
CTGTTGATAGATCCAGTAATGACCTCAGAACTCCATCTGGATTTGTTCAG
AACGCTCGGTTGCCGCCGGGCGTTTTTTATTGGTGAGAATCCAGGGGTCC
CCAATAATTACGATTTAAATTAGTAGCCCGCCTAATGAGCGGGCTTTTTT
TTAATTCCCCTATTTGTTTATTTTTCTAAATACATTCAAATATGTATCCG
CTCATGAGACAATAACCCTGATAAATGCTTCAATAATATTGAAAAAGGAA
GAGTATGAGCATTCAGCATTTTCGTGTGGCGCTGATTCCGTTTTTTGCGG
CGTTTTGCCTGCCGGTGTTTGCGCATCCGGAAACCCTGGGAAGTGAAAGA
TGCGGAGATCACTGGGTGCGCGCGTGGCTAAATGAAGTGGATCTGAAAGC
GGCAAATCTGGAATCTTTCGTCGGAAGACGTTTCGATGAGAGACCTTAAG
GGTGCTGGCGGGGGGTCGAACCGGGGATGCGGCAGAAAATGGCCGCCAAT
CTTAACCAAAGATCGGGAAAAATCCGGGACCAAAAATTGACGAGGGTGCG
GTGGAAGGGGAGGGGAAAAAGAGTAAACCGGGAACTTGTACCATTGGTGG
AAAAGAATTTTTTTTTGGGTATGGGCGGGTGTGGGGGGGAAAAAAAAAAA
AAAAAAACCCGGCTGTCCGCATAGTGGATGTGGCAATGGTTAATTAGAAG
TTGTAATTTTCGGCTTTTCGAGTGGGGGGAGATCTTAGGCTTATCATATG
ATCATCTATATCTTTGAGTCTGGCGCCGTCCATCCTCACGCCTCCCGCAT
TTAGGGAGTCGGGAGGGAGAATTGGGGGAGGGTAA