>H210428-048_I09_1FDFZAF439_premix.ab1	1605
GGCGAGTCGACACACAGATAAAACGAAAGGCCCAGTCTTTCGACTGAGCC
TTTCGTTTTATTTGATGCCTTTAATTAAGAAGCGGAAGAGCGCCCAATAC
GCAAACCGCCTCTCCCCGCGCGTTGGCCGATTCATTAATGCAGCTGGCAC
GACAGGTTTCCCGACTGGAAAGCGGGCAGTGAGCGCAACGCAATTAATGT
GAGTTAGCTCACTCATTAGGCACCCCAGGCTTTACACTTTATGCTTCCGG
CTCGTATGTTGTGTGGAATTGTGAGCGGATAACAATTTCACACAGGAAAC
AGCTATGACCATGATTACGCCAAGCTTGCATGCCTGCAGGTCGACTCTAG
AGGATCCCCGGTCTCTAGCGAACACAACGAGCGATATTTTTGTATACAAT
ATTTTGAAACGATCGTATCTCCTGAGACCGGGTACCGAGCTCGAATTCAC
TGGCCGTCGTTTTACAACGTCGTGACTGGGAAAACCCTGGCGTTACCCAA
CTTAATCGCCTTGCAGCACATCCCCCTTTCGCCAGCTGGCGTAATAGCGA
AGAGGCCCGCACCGATCGCCCTTCCCAACAGTTGCGCAGCCTGAATGGCG
AATGGCGCCTGATGCGGTATTTTCTCCTTACGCATCTGTGCGGTATTTCA
CACCGCATATGGTGCACTCTCAGTACAATCTGCTCTGATGCCGCATAGTT
AAGCCAGCCCCGACACCCGCCAACACCCGCTGAACTAGTCTTGGACTCCT
GTTGATAGATCCAGTAATGACCTCAGAACTCCATCTGGATTTGTTCAGAA
CGCTCGGTTGCCGCCGGGCGTTTTTTATTGGTGAGAATCCAGGGGTCCCC
AATAATTACGATTTAAATTAGTAGCCCGCCTAATGAGCGGGCTTTTTTTT
AATTCCCCTATTTGTTTATTTTTCTAAATACATTCAAATATGTATCCGCT
CATGAGACAATAACCCTGATAAATGCTTCAATAATATTGAAAAAGGAAGA
GTATGAGCATTCAGCATTTTCGTGTGGCGCTGATTCCGTTTTTGCGGCGT
TTGCCTGCCGTGGTTGCGCATCCGGAAACCTGGTGAAAGTGAAAGATGCG
GAAGATCACTGGGTGCGCGCGTGGGCATTTGAACTGGACTGACCACGGAA
AATCTGGAATCTTTCGTCGGAAGACGTTTCCGAGATGACACCTTAAAGGC
TGCGGGCGGGCGGTCTGACCCGGGGAAGCGGCCGAAAAATGGCCTCAATC
TTAATCCGAAGAACGGGGAAATAGCCGGGACAAAAATTGACAGGGGGGCC
GCCGAATGGCGCCGGGAAATCGAGAAAACCCGGAACTGGGGGACCTGGGG
CAAAGAAGATCTTTTAAAAGAAATTCCGGGAGAGAAAAAAAAAAACAAAA
AAAAAACAAGCACGCCACGCCGGTGTGAACCCCCAAAAAAAATGAAGAGG
CCCTGCCTCTGCTTTACGGATTCTCTAGTAAAGAGGAGATAATATATTTA
TTGAGTTGCGAAACTCTACCGCACTCCTCTTACCCTGCTCCGGAGGTACA
CGAACAAGATAACCAACAACCGATGAAGTGACAGCGACTCACGAGACGAT
GAGAT