>H210428-048_O09_1FDFZAF441_premix.ab1	1618
GGGGGGGTCGACACACAGATAAACGAAAGGCCCAGTCTTTCGACTGAGCC
TTTCGTTTTATTTGATGCCTTTAATTAAGAAGCGGAAGAGCGCCCAATAC
GCAAACCGCCTCTCCCCGCGCGTTGGCCGATTCATTAATGCAGCTGGCAC
GACAGGTTTCCCGACTGGAAAGCGGGCAGTGAGCGCAACGCAATTAATGT
GAGTTAGCTCACTCATTAGGCACCCCAGGCTTTACACTTTATGCTTCCGG
CTCGTATGTTGTGTGGAATTGTGAGCGGATAACAATTTCACACAGGAAAC
AGCTATGACCATGATTACGCCAAGCTTGCATGCCTGCAGGTCGACTCTAG
AGGATCCCCGGTCTCTAGCGAACACAACGAGCGATATTTTTGTATACAAT
ATTTTGAAACGATCGTATCTCCTGAGACCGGGTACCGAGCTCGAATTCAC
TGGCCGTCGTTTTACAACGTCGTGACTGGGAAAACCCTGGCGTTACCCAA
CTTAATCGCCTTGCAGCACATCCCCCTTTCGCCAGCTGGCGTAATAGCGA
AGAGGCCCGCACCGATCGCCCTTCCCAACAGTTGCGCAGCCTGAATGGCG
AATGGCGCCTGATGCGGTATTTTCTCCTTACGCATCTGTGCGGTATTTCA
CACCGCATATGGTGCACTCTCAGTACAATCTGCTCTGATGCCGCATAGTT
AAGCCAGCCCCGACACCCGCCAACACCCGCTGAACTAGTCTTGGACTCCT
GTTGATAGATCCAGTAATGACCTCAGAACTCCATCTGGATTTGTTCAGAA
CGCTCGGTTGCCGCCGGGCGTTTTTTATTGGTGAGAATCCAGGGGTCCCC
AATAATTACGATTTAAATTAGTAGCCCGCCTAATGAGCGGGCTTTTTTTT
AATTCCCCTATTTGTTTATTTTTCTAAATACATTCAAATATGTATCCGCT
CATGAGACAATAACCCTGATAAATGCTTCAATAATATTGAAAAAGGAAGA
GTATGAGCATTCAGCATTTTCGTGTGGCGCTGATTCCGTTTTTTGCGGCG
TTTTGCCTGCCGGTGTTTGCGCATCCGGAAACCCTGGTGAAAGTGAAAGA
TGCGGAAGATCACTGGGTGCCCGCGTGGGCTAATTGAACTGGATCTGAAC
AGCGGCAAATTCGGAATTTTTCGCCGGAAGAACGTTTTCCAAGAAGGCAC
CTTTAAAGGCGGTGGGGCGGGGGTTCTAAACCGGGGGATGGGGCAAGAAA
AATGGGCCGCAAATCTTATAACCAAAAATTGGGGGAAAAAACCCGGGACA
AAAATCTGAAGGGGGGTGGACGGGGGGAAGGGGGGGGGGGGATAAAATAA
GGAAAACCCCGGGAACCGGTGGGAAAAATGGGGCCAAAAGATAACCCTTT
TTTAATGGGGAAATGTCCCGGGTTTGGACAAAAGGAAAAACAAAAAAAGA
AACCTCGCCCAGCCGCCTCCCCCGGCTCCCGCCCCCCCCCCCCCAAAAAA
AAAAAATAAAGGCACCCCCCTCCTGTGTCTGAGGGGTTATGATGAAGGGA
TGGGCTGGTGAAGGCCACGTGGGAAGAAAGATAATAGTATATTGGTATGT
GATGCTTGAGTGGGGGTA