>H210519-006_A09_2028ZAA035_premix.ab1	1578
TCCGCCTCGTACCGAAACAACAGATAAAACGAAAGGCCCAGTCTTTCGAC
TGAGCCTTTCGTTTTATTTGATGCCTTAAATTAAAGCGGATAACAATTTC
ACACAGGAGGCCGCCTAGGCCGCGGCCGCGCGAATTCGAGCTCGGTACCC
GGTCTCAACCTCACAAGCGAACACAACGAGCGATATTTTTGTATACAATA
TTTTGAAACGATCGTATCTCCTCTGAGCGAACACAACGAGCGATATTTTT
GTATACAATATTTTGAAACGATCGTATCTCCGTAAAGCGAACACAACGAG
CGATATTTTTGTATACAATATTTTGAAACGATCGTATCTCCTAGTAGCGA
ACACAACGAGCGATATTTTTGTATACAATATTTTGAAACGATCGTATCTC
CTTGCAGCGAACACAACGAGCGATATTTTTGTATACAATATTTTGAAACG
ATCGTATCTCCGGCACATTTGAGACCGGGGATCCTCTAGAGTCGACCTGC
AGGCATGCAAGCTTGCGGCCGCGTCGTGACTGGGAAAACCCTGGCGACTA
GTCTTGGACTCCTGTTGATAGATCCAGTAATGACCTCAGAACTCCATCTG
GATTTGTTCAGAACGCTCGGTTGCCGCCGGGCGTTTTTTATTGGTGAGAA
TCCAGGGGTCCCCAATAATTACGATTTAAATTTGACATAAGCCTGTTCGG
TTCGTAAACTGTAATGCAAGTAGCGTATGCGCTCACGCAACTGGTCCAGA
ACCTTGACCGAACGCAGCGGTGGTAACGGCGCAGTGGCGGTTTTCATGGC
TTGTTATGACTGTTTTTTTGTACAGCCTATGCCTCGTGCCTCCACGCAGC
AAGCGCGTTACGCCGTGAGTCGATGTTCGATGTTATGGAGCAGCCACGAT
GTTACGTAGCAGCATAGATGTCACGTTGCTAGGGCACTCTTCCTAAGACA
AATTTCAGGCGACTCAGCTATCGGTATCATTGGCACCCGAACGCTCGGCC
CATGATCACTCAAAACCTGGCGGATTGCTCTTGGACCTCTACAACGTGGG
CTGAACACGGACCCACTGCTTCCCCAGTGAAACGGATTCGCATCCCATGT
CACTCGCCCTTTAAACCGAAAACCTAAGGCTTGAAGCCCTCGGCCCCCAC
AGTTGGCGCAACCCCCTTTTTTGCGGTTGGCCCACCCCCCCCTTCCCTAA
GGAAAATTTTTTCTCCTTTTTTTTTTAGAAACACCCCCCCGGAAAGGGTT
TTTTTTTTCCTCCCCCCTTTCCCTCCCCTTCTTTTCTTCTTTTTTTCTTC
AGAGGAGAACCCCCCCCCCCCTTAATTCTCCTCCCACCCAAAAACCAAAA
AAAAAATTAAAACCCACAAAAAAACAACAAAAAAAAGCCCGCTTATTTTT
TTTTTTCCCCCCCCCCCCCCCACACAACAAAAAAAGAGAAAAAAAAAAAA
AATCTTCCCCCTCCCTCTCTCCTCCCCCCCCTCCCTCCCTTCCTTCTTTC
GTTTCTCTTTCTTCTTCTCCTCTTCCTTCTTCTTGGATCCCAAACACAAT
AAATTGCCCGCCCACTGCCCCTCTTAGA