>H210519-006_C09_2028ZAA036_premix.ab1	1578
GAAGCGTGTACGACAACACAGATAAAACGAAAGGCCCAGTCTTTCGACTG
AGCCTTTCGTTTTATTTGATGCCTTTAATTAAAGCGGATAACAATTTCAC
ACAGGAGGCCGCCTAGGCCGCGGCCGCGCGAATTCGAGCTCGGTACCCGG
GTCTCACCATTGCCGGAGATACGATCGTTTCAAAATATTGTATACAAAAA
TATCGCTCGTTGTGTTCGCTGCAAGGAGATACGATCGTTTCAAAATATTG
TATACAAAAATATCGCTCGTTGTGTTCGCTACTAGGAGATACGATCGTTT
CAAAATATTGTATACAAAAATATCGCTCGTTGTGTTCGCTTTACGGAGAT
ACGATCGTTTCAAAATATTGTATACAAAAATATCGCTCGTTGTGTTCGCT
CAGAAATGTGAGACCGGGGATCCTCTAGAGTCGACCTGCAGGCATGCAAG
CTTGCGGCCGCGTCGTGACTGGGAAAACCCTGGCGACTAGTCTTGGACTC
CTGTTGATAGATCCAGTAATGACCTCAGAACTCCATCTGGATTTGTTCAG
AACGCTCGGTTGCCGCCGGGCGTTTTTTATTGGTGAGAATCCAGGGGTCC
CCAATAATTACGATTTAAATTTGACATAAGCCTGTTCGGTTCGTAAACTG
TAATGCAAGTAGCGTATGCGCTCACGCAACTGGTCCAGAACCTTGACCGA
ACGCAGCGGTGGTAACGGCGCAGTGGCGGTTTTCATGGCTTGTTATGACT
GTTTTTTTGTACAGCCTATGCCTCGGGCATCCAAGCAGCAAGCGCGTTAC
GCCGTGGGTCGATGTTTGATGTTATGGAGCAGCAACGATGTTACGCAGCA
GCAACGATGTTACGCAGCAGGGCAGTCGCCCTAAAACAAAGTTAGGTGGC
TCAAGTATGGGCATCATTCGCACATGTAGGCTCGGCCCTGACCAAGTCAA
ATCCATGCGGGCTGCTCTTGATCTTTTCGGTCGTGAGTTCGGAGACGTAG
CCACCTACTCCCAACATCAGCCGGACTCCGATTACCTCGGGAACTTGCTC
CGTAGTAAGACATTCATCGCGCTTGCTGCCTTCGACCAAGAAGCGGTTGT
TGGCGCTCTCGCGGCTTACGTTCTGCCCAAGTTTGAGCAGCCGCGTAGTG
AGATCTAAATCTATGATCTCGCAGTCTCGGAAAGCACCGGAGGAGGGGAT
TGCCACGCGCTCATCATCTCCTCAGGATGAGGCAACCGCTTGGTGGTTAG
GGATTACGGCAGCCAATACGGGGACAATCCGCGGGGCTTTTTACAAGGGG
GGGGGGGAAAAAGGGGGCTTTTTTCCCCCCCGCCCCCCCCCAAATTTTTC
AGCCAAAGTTCCCCCCGGAGTTTGAAAAAGAAAACACCCGCGGTTTTTTC
TCTCCCCCCGCGGGGATAAATATTTTAAATACTCTTTTTCAAAAAAAAGA
GAAAGGGAAACCCTTTCTCCCCCCCCCCCGTTATGCGCCCCCTTCGTTTT
TTCTTTCTCTTCTCGGTGATTGGTGGGTGGGGCGCTCGGGCGTCTCGCCG
TTAACAAAAGGTGGTGGTTTCCGTGTGA