>H210519-006_O07_2028ZAA034_premix.ab1	1600
AGACTCTTACTGACACACAGATAAACGAAAGGCCCAGTCTTTCGACTGAG
CCTTTCGTTTTATTTGATGCCTTTAATTAAAGCGGATAACAATTTCACAC
AGGAGGCCGCCTAGGCCGCGGCCGCGCGAATTCGAGCTCGGTACCCGGTC
TCAAGGTTGCCTTTTTCACCGCCGAGATCCAGCGTCAGGCGCAGCAGTTT
GTCAGAACCTTCAACAAACTCTGCGTTTTCAATCAGCGCCACGCGCAGGT
CAACTTTAGCGAAGTCGTCAAAGGTGATGGTTTCCTGAATCGGATCATCT
GCCAGCGGGCCAGTTACCGGCGCGGCAGCGGCTTTTACTTCTTCTTTAGA
GGCTTCCACCAGTGCTTCAACCTGCCTCATATCGATGCGGTTATACAGCG
CCTTGAACGGATTCACTTTGTGGCCCAGCAGCGGTTGCTGGATACCATCC
CAGGTCAGTTCCGTATTGAGGAATGCTTCTGCACGCTCGGTCAGTTTCGG
CAGTACCGGCTTCAGGTAAGTCATCAGCACGCGGAACAGGTTGATGCCCA
TTGAGCAAATTGCCTGCAGGTCGGCATCGCGGCCTTCCTGTTTCGCCACC
ACCCACGGAGCCTGTTCATCGACATAGCGGTTAGCCAGATCAGCCAGCGC
CATGATTTCGCGCACGGCTTTACCAAATTCACGGCTTTCCCACGCTTCAC
CAATCACTTCAGCGGCATCAGTGAAGGTTTTGTACAACTGCGGGTCAGCC
AGTTCGCTTGCCAGCACGCCGTCAAAACGCTTGTTGATAAAGCCCGCATT
ACGGGAGGCCAGGTTAACCACTTTGTTAACGATATCGGCATTCACACGCT
GAACGAAATCTTCCAGGTTGAGATCGATATCATCAATGCGCGAAGAGAGT
TTCGCAGTGTAGTAGTAACGCAGGCTGTCTGCGTCAAAATGATTCAGCCA
GGTGCTGGCTTTAATAAAGGTGCCGCGAGACTTGGACATCTTTGCGCCGT
TCACCGTCACATAGCCATGAACAAACAGGTTGGACGGCTTGCGGAAGTTG
CTGCCTTCCAGCATGGCAGGCCAGAACAGGCTGTGGGAAATACGATCGTT
TCAAATATTGATACAAAATATCGCTCGTTGTGTTCGCTGAGCTTCGTGAG
ACGGGGATCTCTAGAGTCAACTGCAGAATGCAACTTGCGGCGCGTCGTGA
TGGGAAAACCTGGCGAATAATCTTGGAATCTGTTGAAAAACAGAATGACC
CCAAACCCCTTGGATTGTTCAAAGCCCGGGGGCGCGGGGGTTTTTTTTGG
GGAAAACAGGGGCCCCAAAATAAAATAATATTTAAAAAAGGGTGGGGCCA
AAAGATAGGGGAATGGGGGGCCCCCTCGGCCACACCTTCCACCAGGGGGA
GGGGGGGGGGTTTTTTTTTTTTTTTTTTTTTTTCTTCGCCCACCACCGCC
CGGGGGGTGGTTGGAGACAAAAACACACACAACCCCCTAAACCAACTATC
AAGCTTATTGCGTCCTTCGCGCCCGCCGCGCGCGCCACCCCTCGCATCAC
AATTCCAAGACCAATGTGTGTTGGTGTGTGTGTGGTCTTTGATCTAGTTT
