>H210519-006_M07_2028ZAA037_premix.ab1	1589
GGGCGCCGTACGACAACACAGATAAACGAAAGGCCCAGTCTTTCGACTGA
GCCTTTCGTTTTATTTGATGCCTTTAATTAAAGCGGATAACAATTTCACA
CAGGAGGCCGCCTAGGCCGCGGCCGCGCGAATTCGAGCTCGGTACCCGGG
TCTCAGGAGTGCCGGAGATACGATCGTTTCAAAATATTGTATACAAAAAT
ATCGCTCGTTGTGTTCGCTGCAAGGAGATACGATCGTTTCAAAATATTGT
ATACAAAAATATCGCTCGTTGTGTTCGCTACTATACTTGAGACCCGGGGA
TCCTCTAGAGTCGACCTGCAGGCATGCAAGCTTGCGGCCGCGTCGTGACT
GGGAAAACCCTGGCGACTAGTCTTGGACTCCTGTTGATAGATCCAGTAAT
GACCTCAGAACTCCATCTGGATTTGTTCAGAACGCTCGGTTGCCGCCGGG
CGTTTTTTATTGGTGAGAATCCAGGGGTCCCCAATAATTACGATTTAAAT
TTGACATAAGCCTGTTCGGTTCGTAAACTGTAATGCAAGTAGCGTATGCG
CTCACGCAACTGGTCCAGAACCTTGACCGAACGCAGCGGTGGTAACGGCG
CAGTGGCGGTTTTCATGGCTTGTTATGACTGTTTTTTTGTACAGCCTATG
CCTCGGGCATCCAAGCAGCAAGCGCGTTACGCCGTGGGTCGATGTTTGAT
GTTATGGAGCAGCAACGATGTTACGCAGCAGCAACGATGTTACGCAGCAG
GGCAGTCGCCCTAAAACAAAGTTAGGTGGCTCAAGTATGGGCATCATTCG
CACATGTAGGCTCGGCCCTGACCAAGTCAAATCCATGCGGGCTGCTCTTG
ATCTTTTCGGTCGTGAGTTCGGAGACGTAGCCACCTACTCCCAACATCAG
CCGGACTCCGATTACCTCGGGAACTTGCTCCGTAGTAAGACATTCATCGC
GCTTGCTGCCTTCGACCAAGAAGCGGTTGTTGGCGCTCTCGCGGCTTACG
TTCTGCCCAAGTTTGAGCAGCCGCGTAGTGAGATCTATATCTATGATCTC
GCAGTCTCCGGAGAGCACCGGAGGCAGGGCATTGCCACCGCGCTCATCAT
CTCCTCAAGCATGAGGCCACGCGCTTGGTGCTTATGTGATCTACGTGCAA
GCAGATTACGTGGACGATCCCGCAGTGGCTCTCTATACAAGTGGGCATAC
GGGAAGAAGGATGCCTTTGAATCGACCCAGTACCGCCCCTAACATTCTTT
AAGCGAAATGGTTTCCGGCCCGGGAATGTTTCGTAAATTGAAAAAGGCCC
CGCGGTGTCTTTTCCGGCAAAACCCGGTTGGGGGAATAAAAAAAATTTTT
TATATTTCTCTTTTTCTTCAAAAAAAAAATTTTGAGGGGGGGGTTTTTTT
GGGGAGCCGCCGGGGCGGGGGGGAGAAAAAAACCCCCCGAGAGTTTTTTT
TCTTTTTCTTTTTTGGTGAAGAAAAATAGGATTTGTCGGAGGGGGCCCGC
CGGGCTGTGGCGCCCCTCCGTACCAACAAATTAAGAGAAGAGTGGCGTCC
CCCTCTATGCGCGGTGGGAGGGACAATGGCGTTGCACAC