>H210504-044_O15_1FDFZAF483_premix.ab1	1657
TTTGCATATTCGTACGGAGTCGACAACACAGATAAACGAAAGGCCCAGTC
TTTCGACTGAGCCTTTCGTTTTATTTGATGCCTTTAATTAAAGCGGATAA
CAATTTCACACAGGAGGCCGCCTAGGCCGCGGCCGCGCGAATTCGAGCTC
GGTACCCGGGAAGACAACAGAGGAGATACGATCGTTTCAAAATATTGTAT
ACAAAAATATCGCTCGTTGTGTTCGCTTGTGTTGTCTTCGGGGATCCTCT
AGAGTCGACCTGCAGGCATGCAAGCTTGCGGCCGCGTCGTGACTGGGAAA
ACCCTGGCGACTAGTCTTGGACTCCTGTTGATAGATCCAGTAATGACCTC
AGAACTCCATCTGGATTTGTTCAGAACGCTCGGTTGCCGCCGGGCGTTTT
TTATTGGTGAGAATCCAGGGGTCCCCAATAATTACGATTTAAATTTGTGT
CTCAAAATCTCTGATGTTACATTGCACAAGATAAAAATATATCATCATGA
ACAATAAAACTGTCTGCTTACATAAACAGTAATACAAGGGGTGTTATGAG
CCATATTCAGCGTGAAACGAGCTGTAGCCGTCCGCGTCTGAACAGCAACA
TGGATGCGGATCTGTATGGCTATAAATGGGCGCGTGATAACGTGGGTCAG
AGCGGCGCGACCATTTATCGTCTGTATGGCAAACCGGATGCGCCGGAACT
GTTTCTGAAACATGGCAAAGGCAGCGTGGCGAACGATGTGACCGATGAAA
TGGTGCGTCTGAACTGGCTGACCGAATTTATGCCGCTGCCGACCATTAAA
CATTTTATTCGCACCCCGGATGATGCGTGGCTGCTGACCACCGCGATTCC
GGGCAAAACCGCGTTTCAGGTGCTGGAAGAATATCCGGATAGCGGCGAAA
ACATTGTGGATGCGCTGGCCGTGTTTCTGCGTCGTCTGCATAGCATTCCG
GTGTGCAACTGCCCGTTTAACAGCGATCGTGTGTTTCGTCTGGCCCAGGC
GCAGAGCCGTATGAACAACGGCCTGGTGGATGCGAGCGATTTTGATGATG
AACGTAACGGCTGGCCGGTGGAACCGGTGTGGAAAGAAATGCATAAACTG
CTGCCGTTTAGCCCGGAAAGCGTGGTGACCCACGGCGATTTTAGCCTGGA
TAACCTGATTTTCGATGAAGGCAAACTGATTGGCTGCATTGAGTGGGGCC
GGGGGGGCTTGCGGATCCTATTCAGAATCGGCCATTCTGGGAACTGCCTG
GGGGAATTAAACCCCACCCCGCAAAAAGCCTGTTTTAAAAATATGGATTG
TAAAATCGGAAATAAAAAAGGACTTTTCTCCCGCGGGGGTGATTTTTTTA
AAAATAAAGGCCCGGCGCGGCGCTTTTTTTCCTCGCGACCCCCGCGGGGG
GGTAATAAAGTTTTTTACTTCAACCCCCCTCCACAAAAGTTATTTGCAGG
GTGGCTTATCTTTGTTTTCCACGCCCCCCGGACATTAACCCCCACCGGGC
GTTCTTCCCCTTTGGCGCGAAAAGTTAAGGAGGGGGGGCCCACGACACTC
TCAGCCCCTTCCATATATCTTGTTCTCCATTATAGAATTTTTGTGTTATT
GTGGGCGGCGGGGCCCTCCGACGATTAATACTTGAACAGCCGTTTTGACT
TACTTTT