>H210504-044_C17_1FDFZAF482_premix.ab1	1664
GATAAACACGGTATGGGCAGTACGACAACACAGATAAACGAAAGGCCCAG
TCTTTCGACTGAGCCTTTCGTTTTATTTGATGCCTTTAATTAAAGCGGAT
AACAATTTCACACAGGAGGCCGCCTAGGCCGCGGCCGCGCGAATTCGAGC
TCGGTACCCGGGAAGACAATTACGGAGATACGATCGTTTCAAAATATTGT
ATACAAAAATATCGCTCGTTGTGTTCGCTCAGATTGTCTTCGGGGATCCT
CTAGAGTCGACCTGCAGGCATGCAAGCTTGCGGCCGCGTCGTGACTGGGA
AAACCCTGGCGACTAGTCTTGGACTCCTGTTGATAGATCCAGTAATGACC
TCAGAACTCCATCTGGATTTGTTCAGAACGCTCGGTTGCCGCCGGGCGTT
TTTTATTGGTGAGAATCCAGGGGTCCCCAATAATTACGATTTAAATTTGT
GTCTCAAAATCTCTGATGTTACATTGCACAAGATAAAAATATATCATCAT
GAACAATAAAACTGTCTGCTTACATAAACAGTAATACAAGGGGTGTTATG
AGCCATATTCAGCGTGAAACGAGCTGTAGCCGTCCGCGTCTGAACAGCAA
CATGGATGCGGATCTGTATGGCTATAAATGGGCGCGTGATAACGTGGGTC
AGAGCGGCGCGACCATTTATCGTCTGTATGGCAAACCGGATGCGCCGGAA
CTGTTTCTGAAACATGGCAAAGGCAGCGTGGCGAACGATGTGACCGATGA
AATGGTGCGTCTGAACTGGCTGACCGAATTTATGCCGCTGCCGACCATTA
AACATTTTATTCGCACCCCGGATGATGCGTGGCTGCTGACCACCGCGATT
CCGGGCAAAACCGCGTTTCAGGTGCTGGAAGAATATCCGGATAGCGGCGA
AAACATTGTGGATGCGCTGGCCGTGTTTCTGCGTCGTCTGCATAGCATTC
CGGTGTGCAACTGCCCGTTTAACAGCGATCGTGTGTTTCGTCTGGCCCAG
GCGCAGAGCCGTATGAACAACGGCCTGGTGGATGCGAGCGATTTTGATGA
TGAACGTAACGGCTGGCCGGTGGAACAGGTGTGGAAAGAAATGCATAAAC
TGCTGCCGTTTAGCCCGGATAGCGTGGTGACCCACGGCGATTTTAGCCTG
GATAACCTGATTTTCGATGAAGGCAACTGATTGGCTGCATGATGGGGGCC
GGGGGGGCTTGCGGATCGTATCAGGACTGGCCATTCGGGGAACTGCCGGG
GGAATTTACCCCACCGGCAAAACCTTGTTTCAAAAATGGCTTTTAAACCG
GAAAAGAAAAACGCGCTTTTCCTGGGGGGGAGATTTTTTAATAATAGGGG
CCCGCCCCCCCCTGTTCTTTCCCCCTACCCCCCGTGGGGGTTATAAATTT
TTGTTTTTTCCTCTTTTTCCCCACACAAAAGGTTGAGGGGGGGGGATTTT
TTTTTGTCGCGCCCGCGCCCGCGGAGAAGAGAAAAAAACCCCCCCCGCTT
TTTCTCTTTTTTTCTTTTTTTTTAGTTGAGAGGGGAGAGGGGGGGGGGGG
CGCCGCGCCCCCCCCCCCCCCCCCCCAACCCACCCCCCGCCGCCCCTCCC
TGGTTTGGTGGTGGGGGGCGGTGCGCGCGTCCCCCGCCGCCCGACCCGCG
TGGTGTGTGGCGGC