>H210504-044_A17_1FDFZAF480_premix.ab1	1648
GGGGGACCGCGCCCCACAGGGACACACAGATAAAACGAAAGGCCCAGTCT
TTCGACTGAGCCTTTCGTTTTATTTGATGCCTTTAATTAAAGCGGATAAC
AATTTCACACAGGAGGCCGCCTAGGCCGCGGCCGCGCGAATTCGAGCTCG
GTACCCGAAGACAATTGCAGCGAACACAACGAGCGATATTTTTGTATACA
ATATTTTGAAACGATCGTATCTCCGGCATTGTCTTCCCGGGGATCCTCTA
GAGTCGACCTGCAGGCATGCAAGCTTGCGGCCGCGTCGTGACTGGGAAAA
CCCTGGCGACTAGTCTTGGACTCCTGTTGATAGATCCAGTAATGACCTCA
GAACTCCATCTGGATTTGTTCAGAACGCTCGGTTGCCGCCGGGCGTTTTT
TATTGGTGAGAATCCAGGGGTCCCCAATAATTACGATTTAAATTTGTGTC
TCAAAATCTCTGATGTTACATTGCACAAGATAAAAATATATCATCATGAA
CAATAAAACTGTCTGCTTACATAAACAGTAATACAAGGGGTGTTATGAGC
CATATTCAGCGTGAAACGAGCTGTAGCCGTCCGCGTCTGAACAGCAACAT
GGATGCGGATCTGTATGGCTATAAATGGGCGCGTGATAACGTGGGTCAGA
GCGGCGCGACCATTTATCGTCTGTATGGCAAACCGGATGCGCCGGAACTG
TTTCTGAAACATGGCAAAGGCAGCGTGGCGAACGATGTGACCGATGAAAT
GGTGCGTCTGAACTGGCTGACCGAATTTATGCCGCTGCCGACCATTAAAC
ATTTTATTCGCACCCCGGATGATGCGTGGCTGCTGACCACCGCGATTCCG
GGCAAAACCGCGTTTCAGGTGCTGGAAGAATATCCGGATAGCGGCGAAAA
CATGGGGGATGCGCTGGCCGGGTTTCTGCGTCGTTCGCATAGCATTCCGG
TGTGCTACTGATCGTTTTACATGGAACGGGTGGTCCCTTCTGCCCCAGGC
CTAACACGGAATAAAACCTGCTCTGAGCGATGCTAAGGTATTTCCTGATC
CTAGATTGTGCGGTCCAGGTAACGTGCTCAAATAAGGTAATATCGTTCCT
TATCTCCGCGTTACAGGCCATCTCCTGGTATCTTTACCTTTCTTACATAT
TCTCAAGGTGAGATATATGTTTTTGCATGTGTCGTACTCTGTGCATACGT
ACTTGTTACGTAACAGTGCTTTGTTTATTCCTCGTTGTATCTCCCTCTAC
CTTTATTACGCGGGCACTTTAATAGTGAGTTACTCACTTTTGGAAACCCT
TCTCCTCTATAGGGGTCATCTTTAAAGCATAAAACGCCTCCCGAGTGGTT
CTCCTACCCCCCCCGGTCTGTCTTTATTTTTTGTTTAGCTTGTGCATATT
TTTCCTCACTTTGTTTTACTGCTCTTGTTACTCTTTTCGACTCTCCCATA
TATTTTTTGTCCATTTCTTTCTATCCTCTTTATTGGACCTACATTTATCT
GTGCTCTGTCATCGCTGCGCACAATGAACTACACAACACCTTCTGTCTTG
TTTAGCCAAATACTACTACGAACGCTAGATTGATTTGCTATTCAAGACGG
CACTTGGATCTATCTATCTATCTCTTACTTGTGCTTTCTGAAAGCATT