>H210504-044_G17_1FDFZAF481_premix.ab1	1636
CGCATAAATCCGGAAACGACACACAGATAAACGAAAGGCCCAGTCTTTCG
ACTGAGCCTTTCGTTTTATTTGATGCCTTTAATTAAAGCGGATAACAATT
TCACACAGGAGGCCGCCTAGGCCGCGGCCGCGCGAATTCGAGCTCGGTAC
CCGGGAAGACAAACTAGGAGATACGATCGTTTCAAAATATTGTATACAAA
AATATCGCTCGTTGTGTTCGCTTTACTTGTCTTCGGGGATCCTCTAGAGT
CGACCTGCAGGCATGCAAGCTTGCGGCCGCGTCGTGACTGGGAAAACCCT
GGCGACTAGTCTTGGACTCCTGTTGATAGATCCAGTAATGACCTCAGAAC
TCCATCTGGATTTGTTCAGAACGCTCGGTTGCCGCCGGGCGTTTTTTATT
GGTGAGAATCCAGGGGTCCCCAATAATTACGATTTAAATTTGTGTCTCAA
AATCTCTGATGTTACATTGCACAAGATAAAAATATATCATCATGAACAAT
AAAACTGTCTGCTTACATAAACAGTAATACAAGGGGTGTTATGAGCCATA
TTCAGCGTGAAACGAGCTGTAGCCGTCCGCGTCTGAACAGCAACATGGAT
GCGGATCTGTATGGCTATAAATGGGCGCGTGATAACGTGGGTCAGAGCGG
CGCGACCATTTATCGTCTGTATGGCAAACCGGATGCGCCGGAACTGTTTC
TGAAACATGGCAAAGGCAGCGTGGCGAACGATGTGACCGATGAAATGGTG
CGTCTGAACTGGCTGACCGAATTTATGCCGCTGCCGACCATTAAACATTT
TATTCGCACCCCGGATGATGCGTGGCTGCTGACCACCGCGATTCCGGGCA
AAACCGCGTTTCAGGTGCTGGAAGAATATCCGGATAGCGGCGAAAACATT
GTGGATGCGCTGGCCGTGTTTCTGCGTCGTCTGCATAGCATTCCGGTGTG
CAACTGCCCGTTTAACAGCGATCGTGTGTTTCGTCTGGCCCAGGCGCAGA
GCCGTATGAACAACGGCCTGGTGGATGCGAGCGATTTTGATGATGAACGT
AACGGCTGGCCGGTGGAACAGGTGTGGAAAGAAATGCATAAACTGCTGCC
GTTTAGCCCGGATAGCGTGGTGACCCACGGCGATTTTAGCCTGGATAACC
TGATTTTCGATGAAGGCAACTGATTGGCTGCATGGATGGGGCCGTGGGGG
CATTGCGGATCGTTATCAGGATCTGGCCATTCTGGGGAACTGCCTGGGCA
ATTTACCCCAACCTGCAAAACGCTGTTTCAAAAATGGCTTGAAAACGGGA
AGAAAACTGCATTTCTCGGGGGGGAATTTTTTAAAAAATGGACCGGGCCC
CGGTCCTTTCCCCTAACCCGTGGGAATTAAATTTTTATCCTTTTTCCAAA
AAAAGGAGGGGGGGTTTTTTGGGCCGCGCCGGAGAGAAAGAACCCCCGGT
TTTTTTTTTCCCTCGGGGTATGGGGTGGGGCGCCCCCCCCCCCCTCCCCA
CCATCCCTCCTCTTTTTGTTGGGGGGGGGGGCCCCCGCCCCACCAACTGT
ACTTTGATAGCATTTTAAGATATACACTTTCTTTCTTTTTTCTTTTTTTT
TTTTTTTTTTTTTATTACCAACTTATATACCCTTTT