>H210504-044_M15_1FDFZAF484_premix.ab1	1643
TCGTTACGGTAGTTACGACAACACAGATAAAACGAAAGGCCCAGTCTTTC
GACTGAGCCTTTCGTTTTATTTGATGCCTTTAATTAAAGCGGATAACAAT
TTCACACAGGAGGCCGCCTAGGCCGCGGCCGCGCGAATTCGAGCTCGGTA
CCCGGGAAGACAATGTGGGAGATACGATCGTTTCAAAATATTGTATACAA
AAATATCGCTCGTTGTGTTCGCTGAGCTTGTCTTCGGGGATCCTCTAGAG
TCGACCTGCAGGCATGCAAGCTTGCGGCCGCGTCGTGACTGGGAAAACCC
TGGCGACTAGTCTTGGACTCCTGTTGATAGATCCAGTAATGACCTCAGAA
CTCCATCTGGATTTGTTCAGAACGCTCGGTTGCCGCCGGGCGTTTTTTAT
TGGTGAGAATCCAGGGGTCCCCAATAATTACGATTTAAATTTGTGTCTCA
AAATCTCTGATGTTACATTGCACAAGATAAAAATATATCATCATGAACAA
TAAAACTGTCTGCTTACATAAACAGTAATACAAGGGGTGTTATGAGCCAT
ATTCAGCGTGAAACGAGCTGTAGCCGTCCGCGTCTGAACAGCAACATGGA
TGCGGATCTGTATGGCTATAAATGGGCGCGTGATAACGTGGGTCAGAGCG
GCGCGACCATTTATCGTCTGTATGGCAAACCGGATGCGCCGGAACTGTTT
CTGAAACATGGCAAAGGCAGCGTGGCGAACGATGTGACCGATGAAATGGT
GCGTCTGAACTGGCTGACCGAATTTATGCCGCTGCCGACCATTAAACATT
TTATTCGCACCCCGGATGATGCGTGGCTGCTGACCACCGCGATTCCGGGC
AAAACCGCGTTTCAGGTGCTGGAAGAATATCCGGATAGCGGCGAAAACAT
TGTGGATGCGCTGGCCGTGTTTCTGCGTCGTCTGCATAGCATTCCGGTGT
GCAACTGCCCGTTTAACAGCGATCGTGTGTTTCGTCTGGCCCAGGCGCAG
AGCCGTATGAACAACGGCCTGGTGGATGCGAGCGATTTTGATGATGAACG
TAACGGCTGGCCGGTGGAACAGGTGTGGAAAGAAATGCATAAACTGCTGC
CGTTTAGCCCGGATAGCGTGGTGACCCACGGCGATTTTAGCCTGGATACC
TGATTTTCGATGAAGGCAACTGATGGCTGCATGATGTGGGCCGGTGGGCA
TTGCGGATCGTATCAGGATCTGGCCATTCGGGGAACTGCCTGGGGAATTT
ACCCAACCTGCAAAACCTCGGTTCAAAAATGGAATGAAATCCGAATGAAC
AACGGCTTTTTCCTGGGGGAGGTTTTTTTAAATATTTTGCCCGGCCCCCC
GGGCCTTTTCCCACCCCCCCTCGGGGGAAATAAAAATTTTTTAAAACCCC
TTCTAAAAAAAGAGGGGGGGGGGGGGGCTTTGTGTTGTCTCCCCGCCGGA
GAAAGAAAAACACCCCCGGGCTGTTTCTTTCTTACACCCGGGAACGGGGT
TGCGTGGCGGCCCCCTCGCGCGCCTCGCCTCCCCCTCTATCTCTATCGTC
CCCTCCTTGTGTGCTTTGCGCGCGCCAGTGCGCCGCTCCGCCCCCGGCCG
CCGACCCAAGTTTCTCTGACTGTACGTGAGGGCGAAGTGGCGA