>H210504-044_E17_1FDFZAF479_premix.ab1	1771
GGGGGGAGCGCGCGTACGACAACACAGATAAAACGAAAGGCCCAGTCTTT
CGACTGAGCCTTTCGTTTTATTTGATGCCTTTAATTAAAGCGGATAACAA
TTTCACACAGGAGGCCGCCTAGGCCGCGGCCGCGCGAATTCGAGCTCGGT
ACCCGGGAAGACAAGCAAGGAGATACGATCGTTTCAAAATATTGTATACA
AAAATATCGCTCGTTGTGTTCGCTACTATTGTCTTCGGGGATCCTCTAGA
GTCGACCTGCAGGCATGCAAGCTTGCGGCCGCGTCGTGACTGGGAAAACC
CTGGCGACTAGTCTTGGACTCCTGTTGATAGATCCAGTAATGACCTCAGA
ACTCCATCTGGATTTGTTCAGAACGCTCGGTTGCCGCCGGGCGTTTTTTA
TTGGTGAGAATCCAGGGGTCCCCAATAATTACGATTTAAATTTGTGTCTC
AAAATCTCTGATGTTACATTGCACAAGATAAAAATATATCATCATGAACA
ATAAAACTGTCTGCTTACATAAACAGTAATACAAGGGGTGTTATGAGCCA
TATTCAGCGTGAAACGAGCTGTAGCCGTCCGCGTCTGAACAGCAACATGG
ATGCGGATCTGTATGGCTATAAATGGGCGCGTGATAACGTGGGTCAGAGC
GGCGCGACCATTTATCGTCTGTATGGCAAACCGGATGCGCCGGAACTGTT
TCTGAAACATGGCAAAGGCAGCGTGGCGAACGATGTGACCGATGAAATGG
TGCGTCTGAACTGGCTGACCGAATTTATGCCGCTGCCGACCATTAAACAT
TTTATTCGCACCCCGGATGATGCGTGGCTGCTGACCACCGCGATTCCGGG
CAAAACCGCGTTTCAGGTGCTGGAAGAATATCCGGATAGCGGCGAAAACA
TTGTGGATGCGCTGGCCGTGTTTCTGCGTCGTCTGCATAGCATTCCGGTG
TGCAACTGCCCGTTTAACAGCGATCGTGTGTTTCGTCTGGCCCAGGCGCA
GAGCCGTATGAACAACGGCCTGGTGGATGCGAGCGATTTTGATGATGAAC
GTAACGGCTGGCCGGTGGAACAGGTGTGGAAAGAAATGCATAAACTGCTG
CCGTTTAGCCCGGATAGCGTGGTGACCCACGGCGATTTTAGCCTGGATAA
CCTGATTTTCGATGAAGGCAACTGATTGGCTGCATTGATGTGGGCCGGGG
GGCATTGCGGATCGTTATCAGGATCTGGCCTTTTGGGGAACTGCCTGGGG
AATTTACCCCAACCCGCAAAACCTGGTTTCAAAAATGGTTTTAAAACCGA
AAAAAACCACGGTTTTTCTTTGGTGGGGGTAATTTTTATAAATAATATGG
GCCGGCCCCCGCCGCTTTTCTCTCTCACCCCCCCCCGGGGTTATAAAAAT
TTTTTTATTCTCTTTTTCCTCAACAAATATGGAGGGGGGCGGGTTTTTTG
TTTGTTTGCGCCGCGCGCGCGGGGCAAGAAGAAACAGACGACCGGCAGTT
TTTCTTTTTTTTTTTTGTGTATCGATAAGCACATCCCGTCTGTACTGGTA
CTACTGCTGACGCCGTCCCCTCTTCCTGAACAACTTATATCTGTCCTTGT
GTTGGTCGGGGCGGGCGCGCGCGCGCGCGCGCCCCCGCTCCGAGCGACGC
ATCATCGTGTCTCTCTGTGGCGCGATACCTATGCTTCAGAATGGTTAATG
TAGCGCTGGTTTCTTTATTGCGTATGTTACTTATGCCTTTTTGCACCCTG
ATTTATTCATTCTTTGGTTCC